111111111111111111111111111111
1E0M0000000111C000M0000000M001
1M0000000000000000001C00000001
1010101M010M000101001000M10101
10101M010101010001M01M00010101
101010000000000M000000000000C1
1P000000C111CM000011100M000111
111111111111111111111111111111