111111111111111111111111111111
1E000000000111C000000000000001
100000000000000000001C00000001
101010100100000101001000010101
101010010101010001001000010101
1010100000000000000000000000C1
1P000000C111C00000111000000111
111111111111111111111111111111